13,2,1,2,1,2,1,28,9,7,8,8,20,27,1,2,1,2,1,2
1,14,13,14,13,14,14,28,21,7,10,19,7,27,13,1,1,14,13,14
1,14,1,2,1,2,14,40,21,22,8,21,7,39,2,2,1,2,16,38
13,14,11,13,14,14,13,28,22,9,8,21,9,27,13,16,38,38,18,22
1,2,23,2,1,2,1,40,9,20,8,10,7,39,16,18,20,8,20,8
13,14,13,14,13,14,14,1,6,8,10,7,20,17,18,7,19,21,10,5
1,2,1,2,1,2,16,37,18,9,22,8,19,22,21,7,21,7,5,3
13,14,13,14,16,37,18,20,19,19,8,21,19,22,19,19,5,26,3,14
1,16,37,38,18,22,21,22,7,9,22,5,6,5,26,26,2,1,1,2
38,18,7,10,7,9,19,7,21,5,26,14,4,3,14,2,14,1,13,14
20,20,7,20,8,9,5,25,26,3,1,2,1,2,1,2,1,2,1,2
22,20,22,5,25,26,3,14,13,14,13,14,13,14,13,14,13,14,13,14
21,9,5,3,1,2,1,2,1,2,1,2,1,2,1,2,1,2,11,2
25,26,3,14,13,14,13,14,13,14,13,14,13,14,13,14,13,14,23,14
1,2,1,2,1,2,1,2,1,2,1,2,1,2,1,2,1,2,1,2
13,14,13,14,13,14,13,14,13,14,13,14,13,14,13,14,13,14,13,14
1,2,1,2,11,2,1,2,1,2,1,2,1,11,1,2,1,2,1,2
13,14,13,14,23,14,13,14,13,14,13,14,13,23,13,14,13,14,13,14
1,2,1,2,1,2,1,2,1,2,1,2,1,2,1,2,1,2,1,2
13,14,13,14,13,14,13,14,13,14,13,14,13,14,13,14,13,14,13,14